0			0			2848			2848			4			0			
0			0			1424			1424			0			0			
1424			0			1424			1424			0			0			
0			1424			1424			1424			4			0			
0			1424			712			712			0			0			
712			1424			712			712			0			0			
0			2136			712			712			4			0			
0			2136			356			356			4			0			
0			2136			178			178			0			0			
178			2136			178			178			0			0			
0			2314			178			178			0			0			
178			2314			178			178			0			9			296		297		325		329		330		332		603		609		611		
356			2136			356			356			4			0			
356			2136			178			178			0			0			
534			2136			178			178			0			0			
356			2314			178			178			0			7			298		327		336		342		343		352		598		
534			2314			178			178			0			6			10		352		598		599		600		601		
0			2492			356			356			4			0			
0			2492			178			178			0			22			34		66		67		68		69		70		71		72		73		74		75		390		391		392		393		394		395		396		397		398		399		400		
178			2492			178			178			0			35			0		75		76		77		78		79		80		81		82		83		84		85		86		299		300		329		330		338		349		354		400		401		402		403		404		405		406		407		408		409		410		411		603		609		611		
0			2670			178			178			0			0			
178			2670			178			178			0			0			
356			2492			356			356			4			0			
356			2492			178			178			0			42			1		12		86		87		88		89		90		91		92		93		94		95		96		97		229		234		249		252		268		271		336		342		343		352		374		375		378		379		380		411		412		413		414		415		416		417		418		419		420		421		422		595		
534			2492			178			178			0			40			1		10		33		39		40		41		42		97		98		99		100		101		102		194		199		200		201		202		203		303		334		352		375		381		382		383		384		422		423		424		425		426		427		428		429		430		431		432		433		596		
356			2670			178			178			0			0			
534			2670			178			178			0			0			
712			2136			712			712			4			0			
712			2136			356			356			4			0			
712			2136			178			178			0			0			
890			2136			178			178			0			0			
712			2314			178			178			0			1			331		
890			2314			178			178			0			1			4		
1068			2136			356			356			4			0			
1068			2136			178			178			0			0			
1246			2136			178			178			0			7			304		305		306		335		340		341		351		
1068			2314			178			178			0			5			322		323		324		326		328		
1246			2314			178			178			0			7			8		9		602		604		605		606		607		
712			2492			356			356			4			0			
712			2492			178			178			0			39			2		42		43		44		45		46		47		48		49		50		51		52		53		203		204		205		206		207		208		209		210		211		212		213		214		301		331		433		434		435		436		437		438		439		440		441		442		443		444		
890			2492			178			178			0			39			2		3		4		53		54		55		56		57		58		59		60		61		62		63		64		214		215		216		217		218		219		220		221		222		223		224		225		444		445		446		447		448		449		450		451		452		453		454		455		
712			2670			178			178			0			0			
890			2670			178			178			0			0			
1068			2492			356			356			4			0			
1068			2492			178			178			0			23			35		64		65		103		104		105		106		193		225		226		227		455		456		457		458		459		460		461		462		463		464		465		466		
1246			2492			178			178			0			39			5		106		107		108		109		110		111		112		113		114		115		116		117		337		344		345		346		347		348		353		376		385		386		387		388		389		466		467		468		469		470		471		472		473		474		475		476		477		597		
1068			2670			178			178			0			0			
1246			2670			178			178			0			0			
1424			1424			1424			1424			4			0			
1424			1424			712			712			0			0			
2136			1424			712			712			0			0			
1424			2136			712			712			4			0			
1424			2136			356			356			4			0			
1424			2136			178			178			0			7			276		308		309		315		316		317		318		
1602			2136			178			178			0			8			310		311		312		313		314		318		319		321		
1424			2314			178			178			0			16			7		17		18		356		357		358		359		360		361		362		369		370		371		372		608		610		
1602			2314			178			178			0			7			362		363		364		365		366		367		368		
1780			2136			356			356			4			0			
1780			2136			178			178			0			3			307		319		320		
1958			2136			178			178			0			0			
1780			2314			178			178			0			0			
1958			2314			178			178			0			0			
1424			2492			356			356			4			0			
1424			2492			178			178			0			29			17		18		23		27		28		36		118		119		120		121		122		123		124		125		195		302		333		478		479		480		481		482		483		484		485		486		487		488		489		
1602			2492			178			178			0			32			19		20		23		24		25		26		28		29		30		31		32		37		125		126		127		128		129		130		131		196		489		490		491		492		493		494		495		496		497		498		499		500		
1424			2670			178			178			0			0			
1602			2670			178			178			0			0			
1780			2492			356			356			4			0			
1780			2492			178			178			0			36			13		14		131		132		133		134		135		136		137		138		139		140		141		142		230		231		235		236		250		253		254		269		272		273		500		501		502		503		504		505		506		507		508		509		510		511		
1958			2492			178			178			0			45			6		142		143		144		145		146		147		148		149		150		151		152		153		277		278		279		280		281		282		283		284		285		286		287		288		289		290		291		292		293		294		295		511		512		513		514		515		516		517		518		519		520		521		522		612		
1780			2670			178			178			0			0			
1958			2670			178			178			0			0			
2136			2136			712			712			4			0			
2136			2136			356			356			4			0			
2136			2136			178			178			0			8			228		233		238		239		240		257		258		259		
2314			2136			178			178			0			0			
2136			2314			178			178			0			23			15		16		240		241		242		243		244		245		246		247		248		259		260		261		262		263		264		265		266		267		373		377		594		
2314			2314			178			178			0			0			
2492			2136			356			356			4			0			
2492			2136			178			178			0			0			
2670			2136			178			178			0			0			
2492			2314			178			178			0			1			11		
2670			2314			178			178			0			0			
2136			2492			356			356			4			0			
2136			2492			178			178			0			31			21		22		38		153		154		155		156		157		158		159		160		161		197		251		255		270		274		295		339		350		355		522		523		524		525		526		527		528		529		530		531		
2314			2492			178			178			0			26			161		162		163		164		165		166		167		168		169		170		171		172		232		237		256		275		531		532		533		534		535		536		537		538		539		540		
2136			2670			178			178			0			11			562		563		564		565		566		567		568		569		570		571		572		
2314			2670			178			178			0			12			572		573		574		575		576		577		578		579		580		581		582		583		
2492			2492			356			356			4			0			
2492			2492			178			178			0			25			11		172		173		174		175		176		177		178		179		180		181		182		183		540		541		542		543		544		545		546		547		548		549		550		551		
2670			2492			178			178			0			22			183		184		185		186		187		188		189		190		191		192		198		551		552		553		554		555		556		557		558		559		560		561		
2492			2670			178			178			0			11			583		584		585		586		587		588		589		590		591		592		593		
2670			2670			178			178			0			0			
