0			0			2848			2848			4			0			
0			0			1424			1424			0			0			
1424			0			1424			1424			0			0			
0			1424			1424			1424			4			0			
0			1424			712			712			0			0			
712			1424			712			712			0			0			
0			2136			712			712			4			0			
0			2136			356			356			4			0			
0			2136			178			178			0			0			
178			2136			178			178			0			0			
0			2314			178			178			0			0			
178			2314			178			178			0			7			9		301		302		330		334		335		338		
356			2136			356			356			4			0			
356			2136			178			178			0			0			
534			2136			178			178			0			0			
356			2314			178			178			0			2			303		332		
534			2314			178			178			0			0			
0			2492			356			356			4			0			
0			2492			178			178			0			11			39		71		72		73		74		75		76		77		78		79		80		
178			2492			178			178			0			18			0		9		80		81		82		83		84		85		86		87		88		89		90		91		304		305		334		335		
0			2670			178			178			0			0			
178			2670			178			178			0			0			
356			2492			356			356			4			0			
356			2492			178			178			0			20			1		11		91		92		93		94		95		96		97		98		99		100		101		102		234		239		254		257		273		276		
534			2492			178			178			0			20			2		38		44		45		46		47		102		103		104		105		106		107		199		204		205		206		207		208		308		340		
356			2670			178			178			0			0			
534			2670			178			178			0			0			
712			2136			712			712			4			0			
712			2136			356			356			4			0			
712			2136			178			178			0			0			
890			2136			178			178			0			0			
712			2314			178			178			0			1			336		
890			2314			178			178			0			0			
1068			2136			356			356			4			0			
1068			2136			178			178			0			0			
1246			2136			178			178			0			3			309		310		311		
1068			2314			178			178			0			5			327		328		329		331		333		
1246			2314			178			178			0			1			14		
712			2492			356			356			4			0			
712			2492			178			178			0			27			3		47		48		49		50		51		52		53		54		55		56		57		58		208		209		210		211		212		213		214		215		216		217		218		219		306		336		
890			2492			178			178			0			27			4		10		13		58		59		60		61		62		63		64		65		66		67		68		69		219		220		221		222		223		224		225		226		227		228		229		230		
712			2670			178			178			0			0			
890			2670			178			178			0			0			
1068			2492			356			356			4			0			
1068			2492			178			178			0			11			40		69		70		108		109		110		111		198		230		231		232		
1246			2492			178			178			0			13			5		111		112		113		114		115		116		117		118		119		120		121		122		
1068			2670			178			178			0			0			
1246			2670			178			178			0			0			
1424			1424			1424			1424			4			0			
1424			1424			712			712			0			0			
2136			1424			712			712			0			0			
1424			2136			712			712			4			0			
1424			2136			356			356			4			0			
1424			2136			178			178			0			8			281		313		314		320		321		322		323		337		
1602			2136			178			178			0			8			315		316		317		318		319		323		324		326		
1424			2314			178			178			0			3			15		22		23		
1602			2314			178			178			0			1			6		
1780			2136			356			356			4			0			
1780			2136			178			178			0			3			312		324		325		
1958			2136			178			178			0			0			
1780			2314			178			178			0			1			6		
1958			2314			178			178			0			1			7		
1424			2492			356			356			4			0			
1424			2492			178			178			0			18			12		22		23		28		32		33		41		123		124		125		126		127		128		129		130		200		307		339		
1602			2492			178			178			0			21			6		24		25		28		29		30		31		33		34		35		36		37		42		130		131		132		133		134		135		136		201		
1424			2670			178			178			0			0			
1602			2670			178			178			0			0			
1780			2492			356			356			4			0			
1780			2492			178			178			0			23			6		136		137		138		139		140		141		142		143		144		145		146		147		235		236		240		241		255		258		259		274		277		278		
1958			2492			178			178			0			32			7		147		148		149		150		151		152		153		154		155		156		157		158		282		283		284		285		286		287		288		289		290		291		292		293		294		295		296		297		298		299		300		
1780			2670			178			178			0			0			
1958			2670			178			178			0			0			
2136			2136			712			712			4			0			
2136			2136			356			356			4			0			
2136			2136			178			178			0			8			233		238		243		244		245		262		263		264		
2314			2136			178			178			0			0			
2136			2314			178			178			0			20			20		21		245		246		247		248		249		250		251		252		253		264		265		266		267		268		269		270		271		272		
2314			2314			178			178			0			1			8		
2492			2136			356			356			4			0			
2492			2136			178			178			0			0			
2670			2136			178			178			0			0			
2492			2314			178			178			0			1			17		
2670			2314			178			178			0			1			16		
2136			2492			356			356			4			0			
2136			2492			178			178			0			19			18		26		27		43		158		159		160		161		162		163		164		165		166		202		256		260		275		279		300		
2314			2492			178			178			0			18			8		19		166		167		168		169		170		171		172		173		174		175		176		177		237		242		261		280		
2136			2670			178			178			0			0			
2314			2670			178			178			0			0			
2492			2492			356			356			4			0			
2492			2492			178			178			0			13			17		177		178		179		180		181		182		183		184		185		186		187		188		
2670			2492			178			178			0			12			16		188		189		190		191		192		193		194		195		196		197		203		
2492			2670			178			178			0			0			
2670			2670			178			178			0			0			
