0			0			2848			2848			4			0			
0			0			1424			1424			0			0			
1424			0			1424			1424			0			0			
0			1424			1424			1424			4			0			
0			1424			712			712			0			0			
712			1424			712			712			0			0			
0			2136			712			712			4			0			
0			2136			356			356			4			0			
0			2136			178			178			0			0			
178			2136			178			178			0			0			
0			2314			178			178			0			0			
178			2314			178			178			0			9			308		309		337		341		342		344		594		600		602		
356			2136			356			356			4			0			
356			2136			178			178			0			0			
534			2136			178			178			0			0			
356			2314			178			178			0			6			310		339		348		354		355		364		
534			2314			178			178			0			1			364		
0			2492			356			356			4			0			
0			2492			178			178			0			22			46		78		79		80		81		82		83		84		85		86		87		385		386		387		388		389		390		391		392		393		394		395		
178			2492			178			178			0			36			0		24		87		88		89		90		91		92		93		94		95		96		97		98		311		312		341		342		350		361		366		395		396		397		398		399		400		401		402		403		404		405		406		594		600		602		
0			2670			178			178			0			0			
178			2670			178			178			0			0			
356			2492			356			356			4			0			
356			2492			178			178			0			43			1		2		25		98		99		100		101		102		103		104		105		106		107		108		109		241		246		261		264		280		283		348		354		355		364		369		370		373		374		375		406		407		408		409		410		411		412		413		414		415		416		417		590		
534			2492			178			178			0			40			3		4		45		51		52		53		54		109		110		111		112		113		114		206		211		212		213		214		215		315		346		364		370		376		377		378		379		417		418		419		420		421		422		423		424		425		426		427		428		591		
356			2670			178			178			0			0			
534			2670			178			178			0			0			
712			2136			712			712			4			0			
712			2136			356			356			4			0			
712			2136			178			178			0			0			
890			2136			178			178			0			0			
712			2314			178			178			0			1			343		
890			2314			178			178			0			1			9		
1068			2136			356			356			4			0			
1068			2136			178			178			0			0			
1246			2136			178			178			0			7			316		317		318		347		352		353		363		
1068			2314			178			178			0			6			9		334		335		336		338		340		
1246			2314			178			178			0			5			593		595		596		597		598		
712			2492			356			356			4			0			
712			2492			178			178			0			40			5		6		54		55		56		57		58		59		60		61		62		63		64		65		215		216		217		218		219		220		221		222		223		224		225		226		313		343		428		429		430		431		432		433		434		435		436		437		438		439		
890			2492			178			178			0			39			7		8		9		65		66		67		68		69		70		71		72		73		74		75		76		226		227		228		229		230		231		232		233		234		235		236		237		439		440		441		442		443		444		445		446		447		448		449		450		
712			2670			178			178			0			0			
890			2670			178			178			0			0			
1068			2492			356			356			4			0			
1068			2492			178			178			0			24			9		47		76		77		115		116		117		118		205		237		238		239		450		451		452		453		454		455		456		457		458		459		460		461		
1246			2492			178			178			0			40			10		11		118		119		120		121		122		123		124		125		126		127		128		129		349		356		357		358		359		360		365		371		380		381		382		383		384		461		462		463		464		465		466		467		468		469		470		471		472		592		
1068			2670			178			178			0			0			
1246			2670			178			178			0			0			
1424			1424			1424			1424			4			0			
1424			1424			712			712			0			0			
2136			1424			712			712			0			0			
1424			2136			712			712			4			0			
1424			2136			356			356			4			0			
1424			2136			178			178			0			8			288		320		321		327		328		329		330		620		
1602			2136			178			178			0			8			322		323		324		325		326		330		331		333		
1424			2314			178			178			0			15			29		30		599		601		603		604		605		606		607		608		609		616		617		618		619		
1602			2314			178			178			0			7			609		610		611		612		613		614		615		
1780			2136			356			356			4			0			
1780			2136			178			178			0			3			319		331		332		
1958			2136			178			178			0			0			
1780			2314			178			178			0			0			
1958			2314			178			178			0			0			
1424			2492			356			356			4			0			
1424			2492			178			178			0			30			12		29		30		35		39		40		48		130		131		132		133		134		135		136		137		207		314		345		473		474		475		476		477		478		479		480		481		482		483		484		
1602			2492			178			178			0			33			13		31		32		35		36		37		38		40		41		42		43		44		49		137		138		139		140		141		142		143		208		484		485		486		487		488		489		490		491		492		493		494		495		
1424			2670			178			178			0			0			
1602			2670			178			178			0			0			
1780			2492			356			356			4			0			
1780			2492			178			178			0			37			13		14		26		143		144		145		146		147		148		149		150		151		152		153		154		242		243		247		248		262		265		266		281		284		285		495		496		497		498		499		500		501		502		503		504		505		506		
1958			2492			178			178			0			45			15		16		154		155		156		157		158		159		160		161		162		163		164		165		289		290		291		292		293		294		295		296		297		298		299		300		301		302		303		304		305		306		307		506		507		508		509		510		511		512		513		514		515		516		517		
1780			2670			178			178			0			0			
1958			2670			178			178			0			0			
2136			2136			712			712			4			0			
2136			2136			356			356			4			0			
2136			2136			178			178			0			8			240		245		250		251		252		269		270		271		
2314			2136			178			178			0			0			
2136			2314			178			178			0			23			27		28		252		253		254		255		256		257		258		259		260		271		272		273		274		275		276		277		278		279		368		372		589		
2314			2314			178			178			0			0			
2492			2136			356			356			4			0			
2492			2136			178			178			0			0			
2670			2136			178			178			0			0			
2492			2314			178			178			0			1			22		
2670			2314			178			178			0			1			22		
2136			2492			356			356			4			0			
2136			2492			178			178			0			33			17		18		33		34		50		165		166		167		168		169		170		171		172		173		209		263		267		282		286		307		351		362		367		517		518		519		520		521		522		523		524		525		526		
2314			2492			178			178			0			28			19		20		173		174		175		176		177		178		179		180		181		182		183		184		244		249		268		287		526		527		528		529		530		531		532		533		534		535		
2136			2670			178			178			0			11			557		558		559		560		561		562		563		564		565		566		567		
2314			2670			178			178			0			12			567		568		569		570		571		572		573		574		575		576		577		578		
2492			2492			356			356			4			0			
2492			2492			178			178			0			26			21		22		184		185		186		187		188		189		190		191		192		193		194		195		535		536		537		538		539		540		541		542		543		544		545		546		
2670			2492			178			178			0			24			22		23		195		196		197		198		199		200		201		202		203		204		210		546		547		548		549		550		551		552		553		554		555		556		
2492			2670			178			178			0			11			578		579		580		581		582		583		584		585		586		587		588		
2670			2670			178			178			0			0			
