0			0			2848			2848			4			0			
0			0			1424			1424			0			0			
1424			0			1424			1424			0			0			
0			1424			1424			1424			4			0			
0			1424			712			712			0			0			
712			1424			712			712			0			0			
0			2136			712			712			4			0			
0			2136			356			356			4			0			
0			2136			178			178			0			0			
178			2136			178			178			0			0			
0			2314			178			178			0			0			
178			2314			178			178			0			9			257		258		286		290		291		293		362		368		370		
356			2136			356			356			4			0			
356			2136			178			178			0			0			
534			2136			178			178			0			0			
356			2314			178			178			0			7			259		288		297		303		304		313		357		
534			2314			178			178			0			6			6		313		357		358		359		360		
0			2492			356			356			4			0			
0			2492			178			178			0			11			33		65		66		67		68		69		70		71		72		73		74		
178			2492			178			178			0			23			0		74		75		76		77		78		79		80		81		82		83		84		85		260		261		290		291		299		310		315		362		368		370		
0			2670			178			178			0			0			
178			2670			178			178			0			0			
356			2492			356			356			4			0			
356			2492			178			178			0			31			1		12		85		86		87		88		89		90		91		92		93		94		95		96		228		233		297		303		304		313		335		336		339		340		341		354		373		389		392		408		411		
534			2492			178			178			0			28			6		32		38		39		40		41		96		97		98		99		100		101		193		198		199		200		201		202		264		295		313		336		342		343		344		345		355		374		
356			2670			178			178			0			1			372		
534			2670			178			178			0			0			
712			2136			712			712			4			0			
712			2136			356			356			4			0			
712			2136			178			178			0			0			
890			2136			178			178			0			0			
712			2314			178			178			0			1			292		
890			2314			178			178			0			0			
1068			2136			356			356			4			0			
1068			2136			178			178			0			0			
1246			2136			178			178			0			7			265		266		267		296		301		302		312		
1068			2314			178			178			0			5			283		284		285		287		289		
1246			2314			178			178			0			7			8		9		361		363		364		365		366		
712			2492			356			356			4			0			
712			2492			178			178			0			28			2		3		41		42		43		44		45		46		47		48		49		50		51		52		202		203		204		205		206		207		208		209		210		211		212		213		262		292		
890			2492			178			178			0			26			3		4		52		53		54		55		56		57		58		59		60		61		62		63		213		214		215		216		217		218		219		220		221		222		223		224		
712			2670			178			178			0			0			
890			2670			178			178			0			0			
1068			2492			356			356			4			0			
1068			2492			178			178			0			11			34		63		64		102		103		104		105		192		224		225		226		
1246			2492			178			178			0			26			105		106		107		108		109		110		111		112		113		114		115		116		298		305		306		307		308		309		314		337		346		347		348		349		350		356		
1068			2670			178			178			0			0			
1246			2670			178			178			0			0			
1424			1424			1424			1424			4			0			
1424			1424			712			712			0			0			
2136			1424			712			712			0			0			
1424			2136			712			712			4			0			
1424			2136			356			356			4			0			
1424			2136			178			178			0			8			237		269		270		276		277		278		279		377		
1602			2136			178			178			0			8			271		272		273		274		275		279		280		282		
1424			2314			178			178			0			16			10		16		17		317		318		319		320		321		322		323		330		331		332		333		367		369		
1602			2314			178			178			0			7			323		324		325		326		327		328		329		
1780			2136			356			356			4			0			
1780			2136			178			178			0			3			268		280		281		
1958			2136			178			178			0			0			
1780			2314			178			178			0			0			
1958			2314			178			178			0			1			7		
1424			2492			356			356			4			0			
1424			2492			178			178			0			18			5		16		17		22		26		27		35		117		118		119		120		121		122		123		124		194		263		294		
1602			2492			178			178			0			20			18		19		22		23		24		25		27		28		29		30		31		36		124		125		126		127		128		129		130		195		
1424			2670			178			178			0			0			
1602			2670			178			178			0			0			
1780			2492			356			356			4			0			
1780			2492			178			178			0			24			11		13		130		131		132		133		134		135		136		137		138		139		140		141		229		230		234		235		390		393		394		409		412		413		
1958			2492			178			178			0			35			7		141		142		143		144		145		146		147		148		149		150		151		152		238		239		240		241		242		243		244		245		246		247		248		249		250		251		252		253		254		255		256		371		375		376		
1780			2670			178			178			0			0			
1958			2670			178			178			0			0			
2136			2136			712			712			4			0			
2136			2136			356			356			4			0			
2136			2136			178			178			0			8			227		232		378		379		380		397		398		399		
2314			2136			178			178			0			0			
2136			2314			178			178			0			23			14		15		334		338		353		380		381		382		383		384		385		386		387		388		399		400		401		402		403		404		405		406		407		
2314			2314			178			178			0			0			
2492			2136			356			356			0			0			
2136			2492			356			356			4			0			
2136			2492			178			178			0			23			20		21		37		152		153		154		155		156		157		158		159		160		196		256		300		311		316		351		375		391		395		410		414		
2314			2492			178			178			0			18			160		161		162		163		164		165		166		167		168		169		170		171		231		236		351		352		396		415		
2136			2670			178			178			0			0			
2314			2670			178			178			0			0			
2492			2492			356			356			4			0			
2492			2492			178			178			0			12			171		172		173		174		175		176		177		178		179		180		181		182		
2670			2492			178			178			0			11			182		183		184		185		186		187		188		189		190		191		197		
2492			2670			178			178			0			0			
2670			2670			178			178			0			0			
