0			0			2848			2848			4			0			
0			0			1424			1424			0			0			
1424			0			1424			1424			0			0			
0			1424			1424			1424			4			0			
0			1424			712			712			0			0			
712			1424			712			712			0			0			
0			2136			712			712			4			0			
0			2136			356			356			4			0			
0			2136			178			178			0			0			
178			2136			178			178			0			0			
0			2314			178			178			0			0			
178			2314			178			178			0			9			295		296		324		328		329		331		400		406		408		
356			2136			356			356			4			0			
356			2136			178			178			0			0			
534			2136			178			178			0			0			
356			2314			178			178			0			7			297		326		335		341		342		351		395		
534			2314			178			178			0			6			6		351		395		396		397		398		
0			2492			356			356			4			0			
0			2492			178			178			0			11			33		65		66		67		68		69		70		71		72		73		74		
178			2492			178			178			0			23			0		74		75		76		77		78		79		80		81		82		83		84		85		298		299		328		329		337		348		353		400		406		408		
0			2670			178			178			0			0			
178			2670			178			178			0			0			
356			2492			356			356			4			0			
356			2492			178			178			0			31			1		12		85		86		87		88		89		90		91		92		93		94		95		96		228		233		248		251		267		270		335		341		342		351		373		374		377		378		379		392		411		
534			2492			178			178			0			28			6		32		38		39		40		41		96		97		98		99		100		101		193		198		199		200		201		202		302		333		351		374		380		381		382		383		393		412		
356			2670			178			178			0			1			410		
534			2670			178			178			0			0			
712			2136			712			712			4			0			
712			2136			356			356			4			0			
712			2136			178			178			0			0			
890			2136			178			178			0			0			
712			2314			178			178			0			1			330		
890			2314			178			178			0			0			
1068			2136			356			356			4			0			
1068			2136			178			178			0			0			
1246			2136			178			178			0			7			303		304		305		334		339		340		350		
1068			2314			178			178			0			5			321		322		323		325		327		
1246			2314			178			178			0			7			8		9		399		401		402		403		404		
712			2492			356			356			4			0			
712			2492			178			178			0			27			2		41		42		43		44		45		46		47		48		49		50		51		52		202		203		204		205		206		207		208		209		210		211		212		213		300		330		
890			2492			178			178			0			26			3		4		52		53		54		55		56		57		58		59		60		61		62		63		213		214		215		216		217		218		219		220		221		222		223		224		
712			2670			178			178			0			0			
890			2670			178			178			0			0			
1068			2492			356			356			4			0			
1068			2492			178			178			0			11			34		63		64		102		103		104		105		192		224		225		226		
1246			2492			178			178			0			26			105		106		107		108		109		110		111		112		113		114		115		116		336		343		344		345		346		347		352		375		384		385		386		387		388		394		
1068			2670			178			178			0			0			
1246			2670			178			178			0			0			
1424			1424			1424			1424			4			0			
1424			1424			712			712			0			0			
2136			1424			712			712			0			0			
1424			2136			712			712			4			0			
1424			2136			356			356			4			0			
1424			2136			178			178			0			8			275		307		308		314		315		316		317		415		
1602			2136			178			178			0			8			309		310		311		312		313		317		318		320		
1424			2314			178			178			0			16			10		16		17		355		356		357		358		359		360		361		368		369		370		371		405		407		
1602			2314			178			178			0			7			361		362		363		364		365		366		367		
1780			2136			356			356			4			0			
1780			2136			178			178			0			3			306		318		319		
1958			2136			178			178			0			0			
1780			2314			178			178			0			0			
1958			2314			178			178			0			1			7		
1424			2492			356			356			4			0			
1424			2492			178			178			0			18			5		16		17		22		26		27		35		117		118		119		120		121		122		123		124		194		301		332		
1602			2492			178			178			0			20			18		19		22		23		24		25		27		28		29		30		31		36		124		125		126		127		128		129		130		195		
1424			2670			178			178			0			0			
1602			2670			178			178			0			0			
1780			2492			356			356			4			0			
1780			2492			178			178			0			24			11		13		130		131		132		133		134		135		136		137		138		139		140		141		229		230		234		235		249		252		253		268		271		272		
1958			2492			178			178			0			35			7		141		142		143		144		145		146		147		148		149		150		151		152		276		277		278		279		280		281		282		283		284		285		286		287		288		289		290		291		292		293		294		409		413		414		
1780			2670			178			178			0			0			
1958			2670			178			178			0			0			
2136			2136			712			712			4			0			
2136			2136			356			356			4			0			
2136			2136			178			178			0			8			227		232		237		238		239		256		257		258		
2314			2136			178			178			0			0			
2136			2314			178			178			0			23			14		15		239		240		241		242		243		244		245		246		247		258		259		260		261		262		263		264		265		266		372		376		391		
2314			2314			178			178			0			0			
2492			2136			356			356			0			0			
2136			2492			356			356			4			0			
2136			2492			178			178			0			23			20		21		37		152		153		154		155		156		157		158		159		160		196		250		254		269		273		294		338		349		354		389		413		
2314			2492			178			178			0			18			160		161		162		163		164		165		166		167		168		169		170		171		231		236		255		274		389		390		
2136			2670			178			178			0			0			
2314			2670			178			178			0			0			
2492			2492			356			356			4			0			
2492			2492			178			178			0			12			171		172		173		174		175		176		177		178		179		180		181		182		
2670			2492			178			178			0			11			182		183		184		185		186		187		188		189		190		191		197		
2492			2670			178			178			0			0			
2670			2670			178			178			0			0			
