0			0			2848			2848			4			0			
0			0			1424			1424			0			0			
1424			0			1424			1424			0			0			
0			1424			1424			1424			4			0			
0			1424			712			712			0			0			
712			1424			712			712			0			0			
0			2136			712			712			4			0			
0			2136			356			356			4			0			
0			2136			178			178			0			0			
178			2136			178			178			0			0			
0			2314			178			178			0			0			
178			2314			178			178			0			10			0		288		289		317		321		322		324		370		376		378		
356			2136			356			356			4			0			
356			2136			178			178			0			0			
534			2136			178			178			0			0			
356			2314			178			178			0			9			3		4		290		319		328		334		335		344		365		
534			2314			178			178			0			5			344		365		366		367		368		
0			2492			356			356			4			0			
0			2492			178			178			0			11			26		58		59		60		61		62		63		64		65		66		67		
178			2492			178			178			0			25			0		1		2		67		68		69		70		71		72		73		74		75		76		77		78		291		292		321		322		330		341		346		370		376		378		
0			2670			178			178			0			0			
178			2670			178			178			0			0			
356			2492			356			356			4			0			
356			2492			178			178			0			26			3		4		5		6		78		79		80		81		82		83		84		85		86		87		88		89		221		226		241		244		260		263		328		334		335		344		
534			2492			178			178			0			20			25		31		32		33		34		89		90		91		92		93		94		186		191		192		193		194		195		295		326		344		
356			2670			178			178			0			0			
534			2670			178			178			0			0			
712			2136			712			712			4			0			
712			2136			356			356			4			0			
712			2136			178			178			0			0			
890			2136			178			178			0			0			
712			2314			178			178			0			1			323		
890			2314			178			178			0			0			
1068			2136			356			356			4			0			
1068			2136			178			178			0			0			
1246			2136			178			178			0			7			296		297		298		327		332		333		343		
1068			2314			178			178			0			5			314		315		316		318		320		
1246			2314			178			178			0			5			369		371		372		373		374		
712			2492			356			356			4			0			
712			2492			178			178			0			26			34		35		36		37		38		39		40		41		42		43		44		45		195		196		197		198		199		200		201		202		203		204		205		206		293		323		
890			2492			178			178			0			24			45		46		47		48		49		50		51		52		53		54		55		56		206		207		208		209		210		211		212		213		214		215		216		217		
712			2670			178			178			0			0			
890			2670			178			178			0			0			
1068			2492			356			356			4			0			
1068			2492			178			178			0			11			27		56		57		95		96		97		98		185		217		218		219		
1246			2492			178			178			0			19			98		99		100		101		102		103		104		105		106		107		108		109		329		336		337		338		339		340		345		
1068			2670			178			178			0			0			
1246			2670			178			178			0			0			
1424			1424			1424			1424			4			0			
1424			1424			712			712			0			0			
2136			1424			712			712			0			0			
1424			2136			712			712			4			0			
1424			2136			356			356			4			0			
1424			2136			178			178			0			7			268		300		301		307		308		309		310		
1602			2136			178			178			0			8			302		303		304		305		306		310		311		313		
1424			2314			178			178			0			15			9		10		348		349		350		351		352		353		354		361		362		363		364		375		377		
1602			2314			178			178			0			7			354		355		356		357		358		359		360		
1780			2136			356			356			4			0			
1780			2136			178			178			0			3			299		311		312		
1958			2136			178			178			0			0			
1780			2314			178			178			0			0			
1958			2314			178			178			0			0			
1424			2492			356			356			4			0			
1424			2492			178			178			0			17			9		10		15		19		20		28		110		111		112		113		114		115		116		117		187		294		325		
1602			2492			178			178			0			20			11		12		15		16		17		18		20		21		22		23		24		29		117		118		119		120		121		122		123		188		
1424			2670			178			178			0			0			
1602			2670			178			178			0			0			
1780			2492			356			356			4			0			
1780			2492			178			178			0			22			123		124		125		126		127		128		129		130		131		132		133		134		222		223		227		228		242		245		246		261		264		265		
1958			2492			178			178			0			31			134		135		136		137		138		139		140		141		142		143		144		145		269		270		271		272		273		274		275		276		277		278		279		280		281		282		283		284		285		286		287		
1780			2670			178			178			0			0			
1958			2670			178			178			0			0			
2136			2136			712			712			4			0			
2136			2136			356			356			4			0			
2136			2136			178			178			0			8			220		225		230		231		232		249		250		251		
2314			2136			178			178			0			0			
2136			2314			178			178			0			20			7		8		232		233		234		235		236		237		238		239		240		251		252		253		254		255		256		257		258		259		
2314			2314			178			178			0			0			
2492			2136			356			356			0			0			
2136			2492			356			356			4			0			
2136			2492			178			178			0			21			13		14		30		145		146		147		148		149		150		151		152		153		189		243		247		262		266		287		331		342		347		
2314			2492			178			178			0			16			153		154		155		156		157		158		159		160		161		162		163		164		224		229		248		267		
2136			2670			178			178			0			0			
2314			2670			178			178			0			0			
2492			2492			356			356			4			0			
2492			2492			178			178			0			12			164		165		166		167		168		169		170		171		172		173		174		175		
2670			2492			178			178			0			11			175		176		177		178		179		180		181		182		183		184		190		
2492			2670			178			178			0			0			
2670			2670			178			178			0			0			
